1 1 1 1 1 1 1 1 1 1 0 0 3 3 3 3 3 3
1 0 0 0 0 0 0 0 0 1 0 0 3 0 0 0 0 3
1 0 0 1 0 0 0 0 0 1 0 0 3 0 0 0 0 3
1 0 1 0 1 0 0 0 0 1 0 0 3 0 0 0 0 3
1 0 0 1 0 0 0 0 0 1 0 0 3 0 0 0 0 3
1 0 0 0 0 0 0 0 0 3 3 3 3 0 0 0 0 3
1 0 0 0 0 0 0 0 0 0 0 0 0 0 0 0 0 3
1 0 0 5 0 0 0 0 0 0 0 0 0 0 0 0 0 3
1 0 7 0 0 0 0 0 0 3 3 3 3 0 0 0 0 3
1 0 0 0 8 0 0 0 0 1 0 0 0 0 0 0 0 3
1 0 0 0 0 0 0 0 0 1 0 0 0 0 0 0 0 3
1 0 0 0 0 0 0 0 0 1 0 0 0 0 0 0 0 3
1 1 4 0 0 4 1 1 1 2 0 0 0 0 3 3 3 3
0 0 4 0 0 4 0 0 0 2 0 0 6 0 0 0 0 3
0 0 4 0 0 4 0 0 0 2 0 0 2 0 0 0 0 3
0 0 4 0 0 4 0 0 0 2 0 0 2 0 0 0 0 3
0 0 4 0 0 4 0 0 0 2 0 0 2 0 0 0 0 3
0 0 4 0 0 4 0 0 0 2 0 0 6 0 0 0 0 3
0 0 4 0 0 4 4 4 4 4 0 0 2 2 6 6 2 3
0 0 4 0 0 0 0 0 0 0 0 0 4 0 0 0 0 0
0 0 4 0 0 0 0 0 0 0 0 0 4 0 0 0 0 0
0 0 4 4 4 4 4 4 4 4 4 4 4 0 0 0 0 0